1111111
100001
1E00001
1CP0001
1111111
