1111111111111111111
1C01000C00000000001
1C1001C00000K000001
1P10000000000000001
1000C10E00000000001
1111111111111111111
